1 1 1 1 1 1 1 1 1 1 1 1 1 1 1 1 1 1 1 1 1 
1 1 1 1 1 1 1 1 1 1 1 1 1 1 1 1 1 1 1 1 1 
1 1 1 1 1 1 1 1 1 1 1 1 1 1 1 1 1 1 1 1 1 
1 1 1 1 1 1 1 1 1 1 1 1 1 1 1 1 1 1 1 1 1 
1 1 1 1 1 1 1 1 1 1 1 1 1 1 1 1 1 1 1 1 1 
1 1 1 1 1 1 1 1 1 1 1 1 1 1 1 1 1 1 1 1 1 
1 1 1 1 1 1 1 1 1 11 11 11 11 11 11 11 1 1 1 1 1 
1 1 1 1 1 1 1 1 1 11 1 1 1 1 1 11 1 1 1 1 1 
1 1 1 1 1 1 1 1 1 11 1 1 1 1 1 11 1 1 1 1 1 
1 1 1 1 1 1 1 1 1 11 12 1 1 1 1 11 1 1 1 1 1 
1 1 1 1 1 1 1 1 1 11 1 1 1 1 1 11 1 1 1 1 1 
1 1 1 1 1 1 1 1 1 11 11 1 1 1 11 11 1 1 1 1 1 
1 1 1 1 1 1 1 1 1 1 11 11 11 11 13 1 1 1 1 1 1 
1 1 1 1 1 1 1 1 1 1 1 1 1 1 1 1 1 1 1 1 1 
1 1 1 1 1 1 1 1 1 1 1 1 1 1 1 1 1 1 1 1 1 
