11 11 11 11 11 11 11 11 11 11 11 11 11 11 11 11 11 11 11 11 11 
11 1 1 1 1 1 1 1 1 1 1 1 1 1 1 1 1 1 1 1 11 
11 1 1 1 1 1 1 9 1 1 1 1 1 1 9 1 1 1 1 1 11 
11 1 9 1 1 1 1 1 1 1 12 1 1 1 1 1 1 9 1 1 11 
11 1 1 1 1 5 5 5 5 1 1 1 1 1 1 1 1 1 1 1 11 
11 1 1 1 5 5 1 1 5 1 1 1 1 1 1 1 1 1 1 1 11 
11 1 1 1 5 1 1 1 5 1 1 1 1 1 1 1 1 1 1 1 11 
11 8 1 1 5 1 9 1 5 1 1 1 1 1 1 1 9 1 1 1 11 
11 8 8 1 1 1 1 5 5 1 1 1 1 1 1 1 1 1 1 1 11 
11 8 8 8 1 1 5 5 1 1 1 1 1 1 1 13 1 1 1 1 11 
11 8 8 8 8 1 5 5 1 1 1 1 1 1 1 1 1 1 1 1 11 
11 8 8 8 8 1 1 5 5 1 1 1 1 1 1 1 1 1 1 1 11 
11 8 8 8 8 8 1 1 5 1 1 2 1 2 2 2 2 2 1 1 11 
11 8 8 8 8 8 1 1 5 1 1 1 1 1 1 1 1 1 1 1 11 
11 11 11 11 11 11 11 11 11 11 11 11 11 11 11 11 11 11 11 11 11 
